{
    "level_name": "Level 1 - Maze",
    "player_start": [1, 2],
    "astar_start": [5, 5],
    "bc_start": [1, 1],
    "goal": [14, 14],
    "map_size": [15, 15],
    "PLAYER_COOLDOWN_MS": 300,
    "grid": [
        [0, 0, 0, 0, 0, 0, 0, 0, 0, 0, 0, 0, 0, 0, 0],
        [0, 0, 0, 0, 0, 0, 0, 0, 0, 0, 0, 1, 1, 0, 0],
        [0, 1, 0, 0, 0, 0, 0, 0, 0, 0, 0, 1, 0, 0, 0],
        [0, 1, 0, 1, 1, 1, 0, 0, 0, 0, 1, 1, 1, 0, 0],
        [0, 1, 0, 0, 1, 0, 0, 0, 0, 0, 1, 0, 0, 0, 0],
        [0, 1, 0, 0, 0, 0, 0, 0, 1, 1, 1, 0, 0, 0, 0],
        [0, 1, 1, 1, 0, 0, 0, 0, 0, 0, 0, 0, 0, 0, 0],
        [0, 0, 0, 0, 0, 1, 1, 1, 0, 0, 0, 0, 1, 1, 0],
        [0, 0, 0, 0, 0, 0, 0, 0, 0, 0, 0, 0, 1, 0, 0],
        [0, 0, 1, 1, 1, 0, 0, 1, 1, 1, 0, 0, 0, 0, 0],
        [0, 0, 0, 0, 0, 0, 0, 0, 1, 0, 0, 0, 1, 1, 1],
        [0, 0, 0, 1, 1, 1, 1, 0, 1, 0, 1, 1, 1, 0, 0],
        [0, 1, 0, 0, 0, 0, 1, 1, 1, 0, 0, 0, 1, 0, 0],
        [1, 1, 0, 0, 0, 0, 0, 0, 0, 0, 0, 0, 1, 0, 0],
        [0, 0, 0, 0, 0, 0, 1, 1, 1, 1, 0, 0, 0, 0, 0]
    ],
    "music": "assets/audio/Space_Game_Music.mp3",
    "enemy_enabled": false
}